Rue AH : Place du A -> Place du H
Rue GH : Place du H -> Place du G
Rue AG : Place du G -> Place du A
Rue FA : Place du A -> Place du F
Rue EF : Place du F -> Place du E
Rue DE : Place du E -> Place du D
Rue DM : Place du D -> Place du M
Rue MN : Place du M -> Place du N
Rue KN : Place du N -> Place du K
Rue KL : Place du K -> Place du L
Rue CL : Place du L -> Place du C
Rue CB : Place du C -> Place du B
Rue BO : Place du B -> Place du O
Rue MO : Place du O -> Place du M
Rue LM : Place du M -> Place du L
Rue DL : Place du L -> Place du D
Rue DJ : Place du D -> Place du J
Rue HJ : Place du J -> Place du H
Rue HI : Place du H -> Place du I
Rue IP : Place du I -> Place du P
Rue NP : Place du P -> Place du N
Rue NR : Place du N -> Place du R
Rue JR : Place du R -> Place du J
Rue JK : Place du J -> Place du K
Rue EK : Place du K -> Place du E
Rue EH : Place du E -> Place du H
Rue BH : Place du H -> Place du B
Rue BR : Place du B -> Place du R
Rue CR : Place du R -> Place du C
Rue CF : Place du C -> Place du F
Rue FG : Place du F -> Place du G
Rue GI : Place du G -> Place du I
Rue AI : Place du I -> Place du A
